{
  "levels": [
    {
      "id": 0,
      "tiles": [
        "aaaaaaaaaaaaaaaaaaaaaaaaaaaaaaaaaaaaaaa3",
        "a000000000000000000000000000000000000003",
        "a000000000000000000000000000000000000003",
        "a000000000000000000000000000000000000003",
        "a000000000000000000000000000000000000003",
        "a000000000000000000000000000000000000003",
        "a000000000000000000000000000000000000003",
        "a000000000000000000000000000000000000003",
        "a000000000000000000000000000000000000003",
        "a000000000000000000000000000000000000003",
        "a000000000000000000000000000000000000003",
        "a000000000000000000000000000000000000003",
        "a000000000000000000000000000000000000003",
        "a000000000000000000000000000000000000003",
        "a000000000000000000000000000000000000003",
        "a000000000000000000000000000000000000003",
        "a000000000000000000000000000000000000003",
        "a000000000000000000000000000000000000003",
        "a000000000000000000000000000000000000000",
        "a000000000000000000000000000000000000000",
        "a000000000000000000000000000000000000000",
        "a000000000000000000000000000000000000000",
        "1111111111111111111111111111111111111111"
      ],
      "neighbours": {
        "left": -1,
        "right": 1,
        "up": -1,
        "down": -1
      }
    },
    {
      "id": 1,
      "tiles": [
        "3333333333333333333333333333000033333333",
        "3000000000000000000000000000000000000000",
        "3000000000000000000000000000330000000000",
        "3000000000000000000000000000000000000000",
        "3000000000000000000000000000003333333333",
        "3000000000000000000000000000000000000003",
        "3000000000000000000000000000000000000003",
        "3000000000000000000000000000000000000003",
        "3000000000000000000000000000000000000003",
        "3000000000000000000000000000000000000003",
        "3000000000000000000000000000000000000003",
        "3000000000000000000000000000000000000003",
        "3000000000000000000000000000000000000003",
        "3000000000000000000000000000000000000003",
        "3000000000000000000000000000000000000003",
        "3000000000000000000000000000000000000003",
        "3000000000000000000000000000000000000000",
        "3000000000000000000000000000000000000000",
        "3000000000000000000000000000000000000000",
        "0000000000000000000000000000000000000003",
        "0000000000000000000000000000000000000003",
        "0000000000000000000000000000000000000003",
        "1111111111111111111111111111111111111111"
      ],
      "neighbours": {
        "left": 0,
        "right": 2,
        "up": 8,
        "down": -1
      }
    },
    {
      "id": 2,
      "tiles": [
        "3000000000000000000000000000000000000003",
        "0000000000000000000000000000000000000003",
        "0000000000000000000000000000000000000003",
        "0000000000000000000000000000000000000003",
        "3330000000000000000000000000000000000003",
        "3000000000000000000000000000000000000003",
        "3000000000000000000000000000000000000003",
        "3000000000000000000000000000000000000003",
        "3000000000000000000000000000000000000003",
        "3000000000000000000000000000000000000003",
        "3000000000000000000000000000000000000003",
        "3000000000000000000000000000000000000003",
        "3000000000000000000000000000000000000003",
        "3000000000000000000000000000000000000003",
        "3000000000000000000000000000000000000003",
        "3000000000000000000000000000000000000003",
        "0000000000000000000000000000000000000000",
        "0000000000000000000000000000000000000000",
        "0000000000000000000000000000000000000000",
        "1111111111111111111111111111111110011111",
        "1000000000000000000000000000000000000001",
        "1000000000000000000000000000000000000001",
        "1111000011111111111111111111111111111111"
      ],
      "neighbours": {
        "left": 1,
        "right": 5,
        "up": 7,
        "down": 3
      }
    },
    {
      "id": 3,
      "tiles": [
        "2222000022222222222222222222222222222222",
        "2000000000000000000000000000000000000002",
        "2000000000000000000000000000000000000002",
        "2222222222222222222222222222222222000002",
        "0000000000000000000000000000000000000002",
        "0000000000000000000000000000000000000002",
        "0000000000000000000000000000000000000222",
        "2000000000000000000000000000000000000002",
        "0000000000000000000000000000000000000002",
        "0000000000000000000000000000000000022002",
        "0000000000000000000000000000000000000002",
        "2000000000000000000000000000000000000002",
        "2000000000000000000000000000000000000222",
        "2000000000000000000000000000000000000002",
        "2000000000000000000000000000000000000002",
        "2000000000000000000000000000000000022002",
        "2000000000000000000000000000000000000002",
        "2000000000000000000000000000000000000002",
        "2000000000000000000000000000000000000222",
        "0000000000000000000000000000000000000002",
        "0000000000000000000000000000000000000002",
        "0000000000000000000000000000000000000002",
        "2222222222222222222222222222222222222222"
      ],
      "neighbours": {
        "left": 4,
        "right": -1,
        "up": 2,
        "down": -1
      }
    },
    {
      "id": 4,
      "tiles": [
        "2222222222222222222222222222222222222222",
        "2000000000000000000000000000000000000002",
        "2000000000000000000000000000000000000002",
        "2000000000000000000000000000000000000002",
        "2000000000000000000000000000000000000000",
        "2000000000000000000000000000000000000000",
        "2000000000000000000000000000000000000000",
        "2000000000000000000000000000000000000002",
        "2000000000000000000000000000000000000000",
        "2000000000000000000000000000000000000000",
        "2000000000000000000000000000000000000000",
        "2000000000000000000000000000000000000002",
        "2000000000000000000000000000000000000002",
        "2000000000000000000000000000000000000002",
        "2000000000000000000000000000000000000002",
        "2000000000000000000000000000000000000002",
        "2000000000000000000000000000000000000002",
        "2000000000000000000000000000000000000002",
        "2000000000000000000000000000000000000002",
        "2000000000000000000000000000000000000000",
        "2000000000000000000000000000000000000000",
        "2000000000000000000000000000000000000000",
        "2222222222222222222222222222222222222222"
      ],
      "neighbours": {
        "left": -1,
        "right": 3,
        "up": -1,
        "down": -1
      }
    },
    {
      "id": 5,
      "tiles": [
        "3333333333333333333333333333330000333333",
        "3000000000000000000000000000000000100000",
        "3000000000000000000000000000000011100000",
        "3000000000000000000000000000000000100000",
        "3000000000000000000000000000110000100000",
        "3000000000000000000000000000000000100003",
        "3000000000000000000000000000000000000003",
        "3000000000000000000000000000001100000113",
        "3000000000000000000000000000000000000003",
        "3000000000000000000000000000000000000003",
        "3000000000000000000000000000000001100003",
        "3000000000000000000000000000000000000003",
        "3000000000000000000000000000000000000003",
        "3000000000000000000000000000001100000003",
        "3000000000000000000000000000000000000003",
        "3000000000000000000000000000000000000003",
        "0000000000000000000000000000000011000003",
        "0000000000000000000000000000000000000003",
        "0000000000000000000000000000000000000003",
        "3000000000000000000000000000001100000003",
        "3000000000000000000000000000000000000003",
        "3000000000000000000000000000000000000003",
        "3333333333333333333333333333333333333333"
      ],
      "neighbours": {
        "left": 2,
        "right": 10,
        "up": 6,
        "down": -1
      }
    },
    {
      "id": 6,
      "tiles": [
        "3333333333333333333333333333333333333333",
        "3000000000000000000000000000000000000003",
        "3000000000000000000000000000000000000003",
        "3000000000000000000000000000000000000003",
        "3000000000000000000000000000000000000003",
        "3000000000000000000000000000000000000003",
        "3000000000000000000000000000000000000003",
        "3000000000000000000000000000000000000003",
        "3000000000000000000000000000000000000003",
        "3000000000000000000000000000000000000003",
        "3000000000000000000000000000000000000003",
        "3000000000000000000000000000000000000003",
        "3000000000000000000000000000000000000003",
        "3000000000000000000000000000000000000003",
        "3000000000000000000000000000000000000003",
        "3000000000000000000000000000000000000003",
        "0000000000000000000000000000000000000003",
        "0000000000000000000000000000000000000003",
        "0000000000000000000000000000000000000003",
        "0000000000000000000000000000000000000003",
        "3000000000000000000000000000000000000003",
        "3000000000000000000000000000000000000003",
        "3333333333333333333333333333330000333333"
      ],
      "neighbours": {
        "left": 7,
        "right": -1,
        "up": -1,
        "down": 5
      }
    },
    {
      "id": 7,
      "tiles": [
        "aaaaaaaaaaaaaaaaaaaaaaaaaaaaaaaaaaaaaaaa",
        "000000000000000000000000000000000000000a",
        "000000000000000000000000000000000000000a",
        "440000000000000000000000000000000000000a",
        "444400000000000000000000000000000000000a",
        "444440000000000000000000000000000000000a",
        "3000000000000000000000000000000000000004",
        "3000000000000000000000000000000000000044",
        "3000000000000000000000000000000000000444",
        "3000000000000000000000000000000000004444",
        "3000000000000000000000000000000000000003",
        "3000000000000000000000000000000000000003",
        "3000000000000000000000000000000000000003",
        "3000000000000000000000000000000000000003",
        "3000000000000000000000000000000000000003",
        "3000000000000000000000000000000000000003",
        "0000000000000000000000000000000000000000",
        "0000000000000000000000000000000000000000",
        "0000000000000000000000000000000000000000",
        "0000000000000000000000000000000000000000",
        "3300333333333333333333333333333333330033",
        "3000000000000000000000000000000000000003",
        "3000000000000000000000000000000000000003"
      ],
      "neighbours": {
        "left": 8,
        "right": 6,
        "up": -1,
        "down": 2
      }
    },
    {
      "id": 8,
      "tiles": [
        "3000033333333333333333333333333333333333",
        "3000000000000000000000000000000000000003",
        "3000000000000000000000000000000000000003",
        "3110000000000000000000000000000000000003",
        "3000000000000000000000000000000000000003",
        "3000000000000000000000000000000000000003",
        "3001100000000000000000000000000000000003",
        "3000000000000000000000000000000000000003",
        "3000000000000000000000000000000000000003",
        "3110000000000000000000000000000000000003",
        "3000000000000000000000000000000000000003",
        "3000000000000000000000000000000000000003",
        "3001100000000000000000000000000000000003",
        "3000000000000000000000000000000000000003",
        "3000000000000000000000000000000000000003",
        "3110000000000000000000000000000000000003",
        "3000000000000000000000000000000000000000",
        "3000000000000000000000000000000000000000",
        "3001100000000000000000000000000000000000",
        "3000000000000000000000000000000000000000",
        "3000000000000000000000000000000000000003",
        "3000000000000000000000000000000000000003",
        "3333333333333333333333333333000033333333"
      ],
      "neighbours": {
        "left": -1,
        "right": 7,
        "up": 9,
        "down": 1
      }
    },
    {
      "id": 9,
      "tiles": [
        "aaaaaaaaaaaaaaaaaaaaaaaaaaaaaaaaaaaaaaaa",
        "a00000000000000000000000000000000000000a",
        "a00000000000000000000000000000000000000a",
        "a00000000000000000000000000000000000000a",
        "a00000000000000000000000000000000000000a",
        "a00000000000000000000000000000000000000a",
        "a00000000000000000000000000000000000000a",
        "a00000000000000000000000000000000000000a",
        "a00000000000000000000000000000000000000a",
        "a00000000000000000000000000000000000000a",
        "a00000000000000000000000000000000000000a",
        "a00000000000000000000000000000000000000a",
        "a00000000000000000000000000000000000000a",
        "a00000000000000000000000000000000000000a",
        "a00000000000000000000000000000000000000a",
        "a00000000000000000000000000000000000000a",
        "a00000000000000000000000000000000000000a",
        "a00000000000000000000000000000000000000a",
        "3000000000000000000000000000000000000003",
        "3000000000000000000000000000000000000003",
        "3000000000000000000000000000000000000003",
        "3000000000000000000000000000000000000003",
        "3000033333333333333333333333333333333333"
      ],
      "neighbours": {
        "left": -1,
        "right": -1,
        "up": -1,
        "down": 8
      }
    },
    {
      "id": 10,
      "tiles": [
        "1111111111111111111111111111111111111111",
        "0000000000000000000000000000000000000001",
        "0000000000000000000000000000000000000001",
        "0000000000000000000000000000000000000001",
        "0000000000000000000000000000000000000001",
        "1000000000000000000000000000000000000001",
        "1000000000000000000000000000000000000001",
        "1000000000000000000000000000000000000001",
        "1000000000000000000000000000000000000001",
        "1000000000000000000000000000000000000001",
        "1000000000000000000000000000000000000001",
        "1000000000000000000000000000000000000001",
        "1000000000000000000000000000000000000001",
        "1000000000000000000000000000000000000001",
        "1000000000000000000000000000000000000001",
        "1000000000000000000000000000000000000001",
        "1000000000000000000000000000000000000001",
        "1000000000000000000000000000000000000001",
        "1000000000000000000000000000000000000001",
        "1000000000000000000000000000000000000001",
        "1000000000000000000000000000000000000001",
        "1000000000000000000000000000000000000001",
        "1111111111111111111111111111111111111111"
      ],
      "neighbours": {
        "left": 5,
        "right": -1,
        "up": -1,
        "down": -1
      }
    }
  ]
}