{
  "levels": [
    {
      "id": 0,
      "tiles": [
        "2000000000000000000000000000000000000000",
        "2000000000000000000000000000000000000000",
        "2000000000000000000000000000000000000000",
        "2000000000000000000000000000000000000000",
        "2000000000000000000000000000000000000000",
        "2000000000000000000000000000000000004444",
        "2000000000000000000000000000000000000000",
        "2000000000000000000000000000000000000000",
        "2000000000000000000000000000000000000000",
        "2000000000000000000000000000000000000000",
        "2000000000000000000000000000000000000000",
        "2000000111111111000000000000000000000000",
        "2100000000000000000001111100000000000000",
        "2000000000000000000000000000000111100000",
        "2000000000000000000000000000000000000000",
        "2001000000000000000000000000000000000000",
        "2000000000000000000000000011110000000000",
        "2000000000000000011111000000000000000000",
        "2000033330000000000000000000000000000000",
        "2000000000000000000000000000000000000000",
        "2000000000000333300000000000000000000000",
        "2000000000000000000000000000000000000000",
        "1111111111111111111111111111111111111111"
      ],
      "neighbours": {
        "left": -1,
        "right": 1,
        "up": -1,
        "down": -1
      }
    },
    {
      "id": 1,
      "tiles": [
        "0000000000000000000000000000000000000000",
        "0000000000000000000000000000000000000000",
        "0000330000000000000000000000000000000000",
        "0000000000000000000000000000000000000000",
        "0000000000000000000000000000000000000000",
        "4444433000000000000000000000000000000000",
        "0000000000000000000000000000000000000000",
        "0000000033000000000000000000000000000000",
        "0000000000000000000000000000000000000000",
        "0000000000000000000000000000000000000000",
        "0000033000000000000000000000000000000000",
        "0000000000000000000000000000000000000000",
        "0000000000000000000000000000000000000000",
        "0000000330000000000000000000000000000000",
        "0000000000000000000000000000000000000000",
        "0000000000000000000000000000000000000000",
        "0000330000000000000000000000000000000000",
        "0000000000000000000000000000000000000000",
        "0000000000000000000000000000000000000000",
        "0000003300000000000000000000000000000000",
        "0000000000000000000000000000000000000000",
        "0000000000000000000000000000000000000000",
        "1111111111111111111111111111111111111111"
      ],
      "neighbours": {
        "left": 0,
        "right": -1,
        "up": 2,
        "down": -1
      }
    },
    {
      "id": 2,
      "tiles": [
        "0000000000000000000000000000000000000000",
        "0000000000000000000000000000000000000000",
        "0000000000000000000000000000000000000000",
        "0000000000000000000000000000000000000000",
        "0000000000000000000000000000000000000000",
        "0000000000000000000000000000000000000000",
        "0000000000000000000000000000000000000000",
        "0000000000000000000000000000000000000000",
        "0000000000000000000000000000000000000000",
        "0000000000000000000000000000000000000000",
        "0000000000000000000000000000000000000000",
        "0000000000000000000000000000000000000000",
        "0000000000000000000000000000000000000000",
        "0000000000000000000000000000000000000000",
        "0000000000000000000000000000000000000000",
        "0000000000000000000000000000000000000000",
        "0000000000000000000000000000000000000000",
        "0000000000000000000000000000000000000000",
        "0000000000000000000000000000000000000000",
        "0000000000000000000000000000000000000000",
        "0000000000000000000000000000000000000000",
        "0000000000000000000000000000000000000000",
        "1111000011111111111111111111111111111111"
      ],
      "neighbours": {
        "left": 3,
        "right": -1,
        "up": -1,
        "down": 1
      }
    },
    {
      "id": 3,
      "tiles": [
        "1000000000000000000000000000000000000000",
        "1000000000000000000000000000000000000000",
        "1000000000000000000000000000000000000000",
        "1000000000000000000000000000000000000000",
        "1000000000000000000000000000000000000000",
        "1000000000000000000000000000000000000000",
        "1000000000000000000000000000000000000000",
        "1000000000000000000000000000000000000000",
        "1000000000000000000000000000000000000000",
        "1000000000000000000000000000000000000000",
        "1000000000000000000000000000000000000000",
        "1000000000000000000000000000000000000000",
        "1000000000000000000000000000000000000000",
        "1000000000000000000000000000000000000000",
        "1000000000000000000000000000000000000000",
        "1000000000000000000000000000000000000000",
        "1000000000000000000000000000000000000000",
        "1000000000000000000000000000000000000000",
        "1000000000000000000000000000000000000000",
        "1000000000000000000000000000000000000000",
        "1000000000000000000000000000000000000000",
        "1000000000000000000000000000000000000000",
        "1111111111111111111110000111111111111111"
      ],
      "neighbours": {
        "left": -1,
        "right": 2,
        "up": -1,
        "down": 0
      }
    }
  ]
}